0000000000000000000000000000
0111111111111001111111111110
0100001000001001000001000010
0300001000001001000001000030
0100001000001001000001000010
0111111111111111111111111110
0100001001000000001001000010
0100001001000000001001000010
0111111001111001111001111110
0000001000002002000001000000
2222201002222222222001022222
2222201002000000002001022222
2222201C222222222222D1022222
0000001002000110002001000000
6222221112011111101111222226
6222221112011111101111222226
0000001002000000002001000000
2222201A222222222222B1022222
2222201002000000002001022222
2222201002222222222001022222
0000001002000000002001000000
0111111111111001111111111110
0100001000001001000001000010
0100001000001001000001000010
0311001111111111111111001130
0001001001000000001001001000
0111111001000000001001111110
0100000001111001111000000010
0100000000001001000000000010
0111111111111511111111111110
0000000000000000000000000000